NO ./textures/art.xpm
SO ./textures/handsome.xpm
WE ./textures/king.xpm
EA ./textures/superior.xpm


F 125,125,125
C 55,26,246


1111111111111111111111111
1000000000000010000000001
1000000000101010101010101
1000000100101000101011101
10N0000000101111101001001
1000000000100001001100001
1000001111101111001100001
1001000000000000000000001
1111111111111111111111111
