NO ./textures/Glass.xpm
SO ./textures/Glass.xpm
WE ./textures/Bricks.xpm
EA ./textures/Bricks.xpm


F 125,125,125
C 55,26,246


11111111111
10000001001
100N0000001
10000001111
10000000001
10000000001
10000010001
10010000001
11111111111
