NO ./textures/Bricks.xpm
SO ./textures/Gold1.xpm
WE ./textures/WoolSnow.xpm
EA ./textures/TilledSoil.xpm

F 0,145,20
C 120,170,255

1111111111111111111
1000000010201001001
100S001012121211121
1000001210202000201
1000001012121110101
1011111020202010101
1001011211111111121
1111000000000000001
1000010111111111111
1001010010002002001
1001211110011111101
1001001000001001001
1001101010020000201
1001001010010000121
1001111010011111101
1002000010000202001
1111111111111111111